0001

[1:0]-0001
[2:0]-0000
[3:0]-0000
[4:0]-0000
[5:0]-0000
[6:0]-0000


[1:2]-0000
[2:2]-0000
[3:2]-0000
[4:2]-0000
[5:2]-0000
[6:2]-0001


[1:4]-0000
[2:4]-0000
[3:4]-0001
[4:4]-0000
[5:4]-0000
[6:4]-0000


[1:6]-0000
[2:6]-0001
[3:6]-0000
[4:6]-0000
[5:6]-0000
[6:6]-0000

[1:8]-0000
[2:8]-0000
[3:8]-0000
[4:8]-0001
[5:8]-0000
[6:8]-0000




[0:0]-0000
[0:1]-0000
[0:2]-0000
[0:3]-0000
[0:4]-0000
[0:5]-0000
[0:6]-0000
[0:7]-0000
[0:8]-0000
[0:9]-0000

[7:0]-0000
[7:1]-0000
[7:2]-0000
[7:3]-0000
[7:4]-0000
[7:5]-0000
[7:6]-0000
[7:7]-0000
[7:8]-0000
[7:9]-0000

[8:0]-0000
[8:1]-0000
[8:2]-0000
[8:3]-0000
[8:4]-0000
[8:5]-0000
[8:6]-0000
[8:7]-0000
[8:8]-0000
[8:9]-0000

[9:0]-0000
[9:1]-0000
[9:2]-0000
[9:3]-0000
[9:4]-0000
[9:5]-0000
[9:6]-0000
[9:7]-0000
[9:8]-0000
[9:9]-0000